ngx: mgt dpm fiq
obs: din fhn tde
arj: zlz olw
jne: dlg rvw nez znh akl ykj qjd ted ziq nfm lyx fqq clj amn yfx svy hgr vpf lph xjq zhs yqs tjy jyv
qfo: rsh pym
qlu: ssk
iap: zde ahj
zsn: nwa
yob: sot yzl ipk
quk: gbk xee
cam: nfy krb gcg
yzl: keh hqp hyd rwd
ewy: lwq rar ibn
kqf: cba
ine: nyv
ofy: vqw ayn kfa
eyc: nmk ydv
ull: dfr yoo
zuv: bsr fwe zwf
nfi: nby xnr cqg
xry: jne
nmk: tuk zin
ukc: pym rsh
inl: spm vzs vfa
xkn: ylg mub kfe dxo
izh: ogy huj umq
yes: joo foc gbi obs
vfa: yqi rnb xog epo
tzd: mcs
qhl: bcs ilh pwi
nzo: igj vev ezq ovi
jru: uag hmh
fbr: vkw
rll: out
joj: eje
ise: asm
dht: out
tcj: kdy jne cba
yvv: ovi igj vev ezq
wrp: toe qyy
urz: vfk
amn: lbv
olr: loc wqu
jyv: ine fgu rkh sca
mfw: fbc
irq: yzw wff arj
yke: btx
gto: irq voj mjc kwr
gwe: vev ovi
ipk: hyd rwd hqp
cba: jyv lyx clj fqq qjd ykj ted ziq zhs nfm vpf qvq xjq lph znh akl dlg rvw yfx svy nez hgr
gcg: gwv gpd
mzd: dse zsv
xit: igj
gbk: dpm
hqp: aev cps yxl
qjz: ahg mqz
xjq: mod fxr
ovi: ndd xdb rti qzo bys zct eyc qjz jyg ymo tyc rql wdt zfm qhl mwq laf wtr flm zxn
pym: sxa nxd
ubi: lsf rur
mhb: xdl cso ivw klt wwj
dwd: dsb sqa
ilh: kxo kqf
hgg: fbc uvx tui
ghf: fej uzq xqk vup aum
cqg: urz qww yea qqm
kfa: joj
xvy: xnr ikz
okt: vyo
vnr: vip
ube: hbp
nzn: uvx
eje: ssk you nor smf lua
wck: dgm fft uoa
xvi: cba
laf: ilh fyl bcs
lwq: yqm pbh dht
xlh: xee
ebs: kdy jne
xog: hvz
rql: loz xhp qdd fjr kxy
enu: out
cmq: nzn bcr czj
ozq: cba kdy
eys: vev igj
rkh: ejo vcu
ihu: bsr
ekp: eys ozn zvk nzo oap
car: jne kdy cba
lmy: rvh
lnm: jne
qgr: uvx
hmh: cfm
dbx: unc dgm
zry: dke xcl
onc: wce
sot: keh
koc: lua
aiv: odt cfm
umq: cps yxl
jhm: uvx fbc
zbu: ezq vev
iys: ozq
ike: hez
foc: tde
qhm: hcn vjs jru jxv
vvx: ezq ovi
xya: kdr
rvw: zms cbk
odn: fbc tui
yqs: tpz zrm ljr
mjc: yzw arj ydm csw
vqw: joj dac qgv ppy omh
ttt: ise
vaw: yes dke
tcl: yzm cmq qqt
hbp: tui uvx fbc
ojr: fft uoa
vzs: amk xog rnb
zrn: sjt jvv jhm
meb: rxj qif
gov: aev uho cps yxl
kwr: csw ydm yzw
gxb: ueq znm
cdj: nor smf lua ssk you
ctb: zbu
nzv: paa car
ydv: arh nhm zin wtn tuk
qzo: eji vnr skw twk
mml: omx xry tcj
krl: uho cps
ecj: wsy kxs ube hgj
fiq: lur cdj ksy zln
rar: tcm yqm
cta: vyo yxf
din: zoz rjt
qon: ihu ncv
mje: flt ise
tea: xdl cso
igj: bys eyc zct rti ndd iru jyg qjz rql flm zxn laf mwq
smf: xpx mck zpr cam tea wmb dkp rmk fxc oof lsk ull ito dwv lex
ito: pxx qfo uei ukc
yba: nnx qlu njz
ald: out
kfe: zsv jwn luj dse
rpe: lsf iph rur
ghe: nfi
tde: zoz dlc
dzo: wce
dak: mbu eng awg
xpx: ukc pxx
fwe: iyz krl
nez: pem
ciu: xhe vaw yjr wqt iap drz okt ric rmr jbn hrj aie tzd kis
vip: qbt ebs ltp ogk
akv: qfn xub
gze: dhl zlg wce
tyc: cul rvh bfv gtq
zlg: igj
drz: yxf vyo
wtn: lrn
huj: yxl cps uho
opp: rcm nch
ahd: gbk
zhs: mmq
flm: ojr
zfm: wck mqz dbx
fva: xza dhk zrn
wjk: fej xqk vup uzq aum
ric: meb lsc
jyl: zin tuk
rur: dak cqq dyy
wqw: ezq vev igj
fnp: kdy jne cba
agn: hei koc
hqj: mzd
bys: vnr skw twk eji
ymo: jyl nhq
rcm: svp
mck: xvy
vpf: ljr tpz
zvk: ovi
zms: rky zjm
qen: xja dhm
njf: rfr wrp bqm
jyg: pwi bcs fyl
cul: ozq lnm ham
pbh: out
iqx: ecj vkw hgv xny
ahj: ppa jwl
uqc: qen lbq
bsx: gto
rnb: qks zep
dac: eje nji
oel: hbo ahd quk xlh
cqq: mbu eng
jsg: zbb ymw
wce: vev
omx: kdy
nji: you nor smf
zrp: vvx wqw zqz eqn
fkz: you ssk lua nor
xdl: reh ptj
kxs: hbp cgr
lua: blo wmb cam tea cri dwv ull ito uqc lsk ghe lex mhb
iru: gtq bfv rvh iys cul
sce: cps
aer: ezq
stm: nfi ehl
pnu: fkz
xcl: gbi obs kai foc
nyv: tui
svy: zms
jqh: kwr voj
dhl: ovi igj vev
byq: wce dhl kdr
qht: jie iwf
cvf: xub
eng: out
rky: zrn
hdh: tzd dvw gul cta aqu sjk wqt vvb yjv qhm qyi ric
zsv: alg
nhq: zin tuk wtn arh
mxy: meb
sqa: hmu qcb adp
nnx: ssk you nor lua
nch: svp iwf
fcz: igj
nuv: ewy nxd
omh: zpe nji
ksy: ssk you nor lua smf
whv: ilk urf
sxa: rar ibn
cbk: ayx rky zjm fva
gbi: kfr tde
yzw: uaw olw
zlz: out
qbt: jne
qfn: tui
qxm: ilq gov
qww: ptp cck
ehl: ikz xnr nby cqg
cps: oel ckm cre ofy ghf hsl vza kcr wjk njf wzd tyo laa kaj tee lvd ttt
eji: ssx vip
wij: nvb alg
yqi: qks zep sce
hrj: xcl
keh: cps yxl uho
ugv: yvv zbu fcz
tee: bqm
jxv: aiv
jwl: thf vwr ctb
yoo: hez jqh gto
jvv: tui fbc
vjs: qiz aiv uag
alg: wew
blo: wwj klt ivw
kvt: xdq
mrt: out
mwq: ydv jyl tkf
you: ull uqc xpx mck dkp wmb rmk cam mhb
zep: uho
hcn: uag
kai: kfr fhn din
vgh: gbk ngx
inu: ube sxx
qbz: hei koc
xqk: qbz agn oct rtl
vev: qjz tyc jyg ymo iru ndd rti akp qzo bys eyc mwq laf wtr flm lmy zxn wdt zfm qhl
rvo: uba
jql: vev
dnq: ott
hwr: nch
ibn: tcm pbh yqm dht
kfr: jql rjt zoz
alp: amk xog epo rnb
svp: out
btx: tui fbc
dwv: lbq qen qfq
ptp: ict nal jyo ald
fky: nor lua ssk you
dxo: zsv jwn
bfv: lnm ham
awx: qiz
gwd: ugv
ndd: bcs pwi
toe: njz
lrn: tcj omx
jwn: alg nvb
zoz: ovi ezq vev
qgk: lua ssk
fgy: cck
qqm: vfk cck
zrm: fov
dfr: hez rwu jqh
dkp: bsx fmv
qdd: nzv dno
gtq: ozq lnm
ozn: vev
sxx: cgr
dyy: mbu mrt
xdb: ydv nmk nhq jyl
kdy: zhs yqs tjy svy hgr yfx amn lph xjq vpf ziq nfm ted ykj qjd lyx fqq clj rvw dlg akl qvq znh
dlm: gze byq dzo onc
kse: ssk smf
nul: gwd
vio: ecj
reh: zjv whv guw
gys: ssk you nor smf
jyo: out
hyd: cps yxl uho
wdt: iys
fxr: lcm
snc: uho aev yxl cps
wsy: cgr hbp
ydm: uaw olw zlz
kcr: kfa ayn vqw
kdr: ovi ezq igj
oyi: pnw kmw qgk
rjt: ezq vev igj ovi
yjr: ggc dlm
wqt: ahj
voj: arj csw wff yzw
zpr: xvy nfi ehl
cvr: jne kdy
ilk: rll loc
urn: tcm dht
dke: gbi
iri: nch
loz: dno zsn nzv
thf: aer fcz yvv
wff: uaw
hmu: huj cdn
qee: cmq qqt
lbq: cws sic xja dhm
qqt: czj ocy nzn bcr mfw
uql: qfn uba xub
nal: out
qks: aev uho yxl cps
sic: opp fex
sjt: tui
ott: izh hmu qcb adp
nwa: cba jne kdy
qcb: huj zrz cdn
vvb: dke yes
laa: wrp
arh: lfm mml lrn hcy
wlk: ylg
uzq: agn qbz rtl
znm: alp spm
cws: iri opp
ckm: flt tmi
fft: gnf fnp
ppf: ueq
fmv: gto rwu
fgu: pwn
uvx: tiq xkn kvt rkd kye veb dnq kvc hqj wlk gxb
xnr: qqm fgy urz
qiz: odt ekp cfm
jzn: fbc uvx
pwn: tui
svr: ciu hdh jmf
nor: zpr stm oof est uqc
ict: out
bcr: tui uvx fbc
cdn: yxl uho aev
rwd: yxl cps uho aev
dsb: qcb
gul: dlm
adp: huj ogy cdn umq
vfk: ald ict nal
wzd: xlh vgh quk ahd
ayn: dac qgv omh
ted: fbr vio gte dqu
cri: lbq
glg: tui uvx
gpd: rur
vza: fej uzq vup xqk
vwr: aer fcz gwe yvv
tui: rkd xkn yob dwd veb kye qon dnq ppf mwh wlk gxb
ymw: akv cfz
iph: dyy
vkw: sxx ube kxs wsy
ssx: ebs gqi ltp
qvq: egd
yea: ptp cck
lfm: xvi
cbe: kse nnx njz qlu gys
paa: kdy
gte: ecj hgv
ogk: cba jne kdy
qgv: zpe eje nji
qyi: vjs jru hcn
lsk: uei
ziq: sca mmq ine fgu
vup: qbz oct rtl
hsl: rfr
wym: snc
ncv: fwe bsr qxm
dno: cvr car paa nwa
hgy: zjv
zct: rvh cul iys
frm: loc
mgt: cdj lur zln
mmq: glg
jej: uql cvf akv
ekk: fjr qdd xhp loz
mbu: out
zwf: ilq gov iyz
urf: rll wqu enu
epo: sce qks zep
xhp: eit
mcs: mcu rxj qif
zpe: smf lua ssk
uaw: out
vuf: zbb jej
lcm: fbc
oap: igj ezq
yqm: out
xja: iri fex hwr
cso: ptj
hbo: gbk ngx
kxy: dno eit
kvc: sun yzl
ezq: ndd xdb eyc zct bys qjz ymo rql zfm qhl mwq ekk zxn lmy flm wtr
uoa: fnp wbw
zjv: frm
hez: kwr voj mjc
unc: fnp usx
dhm: hwr
iyz: uho
wtr: eji twk
cfz: xub
xfb: btx jzn lcm odn
aie: yxf vyo
jmf: zry yjv mxy ehz qyi ric okt aie hrj rmr wqt vaw yjr vvb drz aqu iap
dqu: hgv inu
wbw: jne
qyy: nnx qlu
ggc: dzo xya byq gze
xdo: rur rng iph lsf
wmb: ike yoo
est: dfr fmv bsx
dgm: wbw usx fnp gnf
jie: out
qjd: pem vuf
amk: zep
rwu: mjc
rsc: umq cdn zrz huj
akp: xhp kxy fjr loz
sca: vcu ejo nyv pwn
olw: out
wun: dzo gze byq xya
sun: hyd hqp
fjr: eit dno nzv
nhm: hcy lrn pyf
tyo: xlh vgh hbo
nfm: yke xfb fxr
pwi: peq
pem: jej ymw zbb
xza: jhm jvv sjt
akl: egd cbk
xhe: meb
lur: ssk you smf
cck: jyo
bqm: cbe toe yba
kaj: vup xqk uzq
uba: tui uvx
uho: njf wjk rwa kcr vza cre ofy hsl ghf oel ckm mje ttt kaj tee lvd laa tyo
tuk: mml
ilq: aev
rsh: nxd sxa ewy
gwv: iph lsf rur
mub: luj dse jwn wij zsv
mod: lcm jzn btx qgr
oku: yxl cps uho
xny: hgj
zin: lrn hcy
hgr: xfb
lex: krb nfy ves quu
pnw: ssk you lua nor
egd: fva
ogy: aev
skw: tdu ssx vip
zjm: zrn xza
wew: uho aev yxl cps
dhp: ott ewm sqa
nvb: oku wew
xdq: qxm xyh fwe zwf
kmw: lua smf nor you
dvw: dlm
zrz: yxl aev
hei: smf ssk
klt: reh
usv: hwr iri
czj: tui uvx
quu: rpe
luj: nvb
oof: nfy krb quu
yxf: xit zqz wqw vvx
ehz: zde nul
yxl: ttt wjk tee lvd laa vza hsl ghf ofy oel wzd
mdq: nor lua smf
cre: wrp
fqq: sca rkh fgu
asm: qgk kmw pnw fkz
tjy: dqu gte fbr vio
fhn: zoz jql dlc
mwh: xdq ncv zuv
zxn: tkf
lvd: kfa vqw ayn
ikz: urz fgy qqm
hvz: aev cps yxl
ayd: kse
rvh: ham lnm
eqn: igj
ppy: zpe
nfy: xdo ubi rpe
fyl: kqf kxo
ltp: cba
ahg: fft
ham: kdy jne cba
awg: out
spm: amk rnb xog yqi
aum: qbz agn
iwf: out
lbv: jej ymw
nxd: ibn rar lwq urn
veb: zuv
rmr: mcs lsc meb
qfq: usv cws sic dhm
vcu: uvx fbc
rtl: hei fky koc
nzd: ctb
kxo: jne kdy cba
dnn: gwe
rwa: ise flt tmi
rmk: ehl nfi
vyo: xit
ocy: tui
loc: out
njz: nor
yjv: wun dlm ggc
ivw: reh ptj
fov: otv
kye: znm inl
aev: mje rwa tee kaj lvd ghf hsl tyo oel ckm
aqu: jxv awx vjs
wwj: hgy reh
gnf: cba kdy jne
tdu: ltp ogk qbt ebs
mqz: unc fft dgm uoa
hcy: tcj xvi xry omx cvi
pyf: omx cvi xvi
dlc: ovi igj ezq
fbc: yob tiq dwd kpa lov dhp kvc qon tdd dnq mwh wlk hqj
dhk: sjt jvv jhm
otv: bcr nzn mfw czj ocy
lsc: qif mcu
usx: jne kdy
mcu: ezq vev igj ovi
rfr: toe cbe yba ayd
zln: ssk smf nor
ylg: zsv jwn dse luj
bcs: kxo peq kqf
ptj: whv guw zjv
krb: xdo gwv gpd
zbb: rvo cvf cfz akv
csw: zlz olw uaw
ssk: mhb lex lsk uqc ghe oof ull cam tea cri fxc wmb dkp xpx mck stm zpr blo
lov: ipk
lsf: cqq dyy
yfx: pem jsg lbv
tpz: qee fov
twk: ssx tdu vip
hgj: hbp hgg
ayx: xza
tiq: yzl sun
dpm: lur mdq
cvi: kdy cba
ppa: ugv thf dnn ctb
jbn: zde ahj
tkf: nhm tuk wtn zin
gqi: cba
dse: wym
nbp: ewy sxa nxd
tcm: out
cfm: eys oap
xub: uvx fbc
fxc: qfq qen
dlg: vio fbr gte iqx
peq: jne kdy
zde: nzd gwd ppa
guw: frm ilk olr
uei: rsh pym nuv
oct: hei fky
clj: yke
yzm: mfw
fej: rtl oct
xee: mgt
ueq: spm vzs alp
ljr: fov tcl
eit: paa
rkd: dxo kfe mub
hgv: wsy kxs ube hgj
odt: oap zvk eys ozn
rti: qdd xhp fjr
wqu: out
lph: ine
kpa: dxo
rng: dak
upd: qee tcl
sjk: zrp vyo
tdd: dsb ewm sqa
ykj: pem vuf lbv
tmi: asm pnu
nby: yea
xyh: iyz krl
flt: pnu oyi
lyx: zrm upd ljr
pxx: nbp
cgr: uvx fbc
znh: ljr
uag: ekp cfm
qif: ovi igj vev
rxj: igj ezq
kis: wun
bsr: iyz gov
zqz: ezq vev
joo: fhn
ejo: uvx tui
ewm: rsc
fex: qht
ves: gpd gwv xdo ubi rpe